### || ما يستفاد من قوله تعالى سورة الأعراف
: {وَاتْلُ عَلَيْهِمْ نَبَأَ الَّذِي آتَيْنَاهُ
آيَاتِنَا فَانْسَلَخَ مِنْهَا} ]
قال الشيخ محمد بن عبد الوهاب رحمه الله تعالى: وقوله عز وجل: {وَاتْلُ
عَلَيْهِمْ نَبَأَ الَّذِي آتَيْنَاهُ آيَاتِنَا فَانْسَلَخَ مِنْهَا}
[سورة الأعراف آية: 175] فيه مسائل:
الأولى: معرفة أن لا إله إلا الله، كما في قصة آدم وإبليس، ويعرف ذلك من
عرف أسباب الشرك: وهو الغلو في الصالحين، والجهل بعظمة الله.
الثانية: معرفة أن محمدا رسول الله، يعرفه من عرف عداوة علماء أهل الكتاب
له.
الثالثة: معرفة الدين الصحيح والدين الباطل، لأنها نزلت في إبطال دينهم
الذي نصروا، وتأييد دينه الذي أنكروا.
الرابعة: معرفة عداوة الشيطان ومعرفة حيله.
الخامسة: أن من انسلخ من الآيات أدركه الشيطان، ومن لم ينسلخ منها حمته
منه، ثم صار أكثر من ينتسب إلى العلم يظن العكس.
السادسة: خوف الخاتمة كما في حديث ابن مسعود.
السابعة: عدم الاغترار بغزارة العلم.
الثامنة: عدم الاغترار بصلاح العمل.
التاسعة: عدم الاغترار بالكرامات وإجابة الدعاء.
العاشرة: أن الانسلاخ لا يشترط فيه الجهل بالحق أو بغضه.
الحادية عشر: أن من أخلد إلى الأرض واتبع هواه، فلو عرف الحق وأحبه 1 وعرف
الباطل وأبغضه. 1 لعله فقد انسلخ، ولو عرف إلخ ...


‏PageV013P00204

الثانية عشر: معرفة الفتنة وأنه لا بد منها; فليتأهب وليسأل الله العافية،
لقوله: {أَحَسِبَ النَّاسُ أَنْ يُتْرَكُوا أَنْ يَقُولُوا آمَنَّا وَهُمْ
لا يُفْتَنُونَ} [سورة العنكبوت آية: 2] الآيتين.
الثالثة عشر: عدم أمن مكر الله.
الرابعة عشر: عقوبة العاصي في دينه ودنياه.
الخامسة عشر: ذكر مشيئة الله، وذكر السبب من العبد.
السادسة عشر: أن محبة الدنيا تكون سببا لردة العالم عن الإسلام.
السابعة عشر: تمثيل هذا العالم بالكلب في اللهث على كل حال.
الثامنة عشر: أن هذا مثل لكل من كذب بآيات الله، فليس مختصا.
التاسعة عشر: ذكر كونه سبحانه أمر بقص القصص على عباده.
العشرون: ذكر الحكمة في الأمر به.
الحادية والعشرون: قوله: {سَاءَ مَثَلًا} كقوله: {بِئْسَ مَثَلُ الْقَوْمِ}


