### || ذكر بعض ما في قصة الجاهلية المذكورة في السيرة من الفوائد
وقال أيضا: رحمه الله تعالى:
ذكر بعض ما في قصة الجاهلية المذكورة في السيرة، من الفوائد:
الأولى: ما في قصة ود، وسواع، ويغوث، ويعوق، ونسر من بيان الشرك بالله;
وإزالة الشبهة التي أدلى بها المشركون، من قولهم: نريد الجاه والشفاعة،
وقولهم: ليس دعوة الصالحين مثل الأصنام وقولهم: نحن نعلم أن الله هو النافع
الضار وقولهم: هؤلاء ولو أشركوا، فهم من أمة محمد; وقول شياطينهم: هذا شرك
أصغر. فكل هذا: يكشفه قصتهم.
الثانية: مضرة البدع ولو صح قصد مبتدعها، وأنها سبب للخروج عن الإسلام.
الثالثة: التحذير من الغلو.
الرابعة: كون الحق في القلوب ينقص، والباطل يزيد.
الخامسة: التحذير من الكذب على العلماء، وقد يكون الكاذب لم يتعمد.
السادسة: معرفة أن الأصنام لم تعبد لذاتها; وإنما عبدت لأجل الصالحين.
السابعة: أن الردة وعبادة الأصنام، قد يكون سببها فعل بعض الصالحين.
الثامنة: التحذير من الفتنة بقبور الصالحين، لقوله: ]عكفوا على قبورهم .
التاسعة: أن من أسباب الردة بعد الأمد عن النبوة.
العاشرة: أن من أسبابها: نسيان العلم.
الحادية عشر: ما في قصة عمرو بن لحي من التحذير من فتنة البلد الحرام.
الثانية عشر: التحذير من فتنة أهل الشام.
الثالثة عشر:


‏PageV02P00147

التفطن لما أعطي عمرو من الأعمال.
الرابعة عشر: ما أعطى من الكمال.
الخامسة عشر: ما أعطى من الملك.
السادسة عشر: ما أعطى من طاعة الناس له.
السابعة عشر: التفطن للفرق بين: كرامات الأولياء، وتنزل الشياطين.
الثامنة عشر: أن من علامات الباطل زيادته كل وقت، وعلامات الحق ثقله
ونقصانه. التاسعة عشر: العبرة برؤية النبي صلى الله عليه وسلم له في النار.
العشرون: اللطيفة: كون صور الصالحين يبعث عليها أول الرسل، ولم يكسرها إلا
خاتم الرسل. الحادية والعشرون: معرفة أن الكفار لم يقصدوا بالشرك وعبادة
الأصنام إلا الخير. الثانية والعشرون: كون بعض الأوثان عندهم أعظم من بعض.
الثالثة والعشرون: تفرقهم واختلافهم، في تعظيم أوثانهم وفي عبادتها.
الرابعة والعشرون: كونهم في أمر مريج وفي قول مختلف، يقولون: إن الأمر بيد
الله لا يدبر إلا هو، ويقولون: {اعْتَرَاكَ بَعْضُ آلِهَتِنَا بِسُوءٍ}
[سورة هود آية: 54] . الخامسة والعشرون: فعلهم العبادات1.


