### || المسائل المستنبطة من قوله تعالى
 {يَا أَيُّهَا الَّذِينَ آمَنُوا إِنْ تُطِيعُوا فَرِيقاً مِنَ الَّذِينَ أُوتُوا الْكِتَابَ} ]
قال الشيخ محمد بن عبد الوهاب، رحمه الله تعالى: ومن قوله: {يَا أَيُّهَا
الَّذِينَ آمَنُوا إِنْ تُطِيعُوا فَرِيقاً مِنَ الَّذِينَ أُوتُوا
الْكِتَابَ [سورة آل عمران آية: 100] إلى قوله {وَمَا اللَّهُ يُرِيدُ
ظُلْماً لِلْعَالَمِينَ} [سورة آل عمران آية: 108] .
الأولى: سبب النّزول يدل على شدة الحاجة لها، فإذا احتاجوا فكيف بغيرهم؟ !
الثانية: الخوف على مثلهم الردة بذلك، فكيف بمن دونهم؟ ! .
الثالثة: أن فيمن أوتي الكتاب من يدعو إلى الردة، مثلما أن فيهم من يدعو
إلى الله.
الرابعة: التصريح بأن ذلك بعد الإيمان.
الخامسة: لطف الله تعالى بعبده بدعوتهم بهذا الوصف.
السادسة: استبعاد الكفر ممن تتلى عليهم آيات الله وفيهم رسوله، فإذا مضت
الثانية فالأولى باقية.
السابعة: أن آيات الله لا نظير لها في دفع الشر في سائر الكلام، كما أن
رسوله لا نظير له في سائر الأشخاص في دفع ذلك.
الثامنة: الرد على أعداء الله الذين يزعمون أن القرآن لا يفهم معناه.
التاسعة: أن الاعتصام بحبل الله جامع.
العاشرة: أن الطرق فيها المعوج وفيها المستقيم.
الحادية عشر: ذكر حق تقاته.
الثانية عشر: لطافة الخطاب.
الثالثة عشر: لزوم


‏PageV013P00130

الإسلام إلى الممات.
الرابعة عشر: فيه التنبيه على قوله: " لا ترجعوا بعدي كفارا يضرب بعضكم
رقاب بعض " 1 لأن ذلك سبب النّزول.
الخامسة عشر: كون الإسلام طاعة الرسول ومعصية أولئك.
السادسة عشر: خوفك من الردة وإن كنت من الصالحين.
السابعة عشر: ذكر الاعتصام بحبل الله، وهو القرآن ; ففيه دليل على أنه
عصمة.
الثامنة عشر: الأمر بالاجتماع على ذلك.
التاسعة عشر: تأكيده ما تقدم بالنهي عن الافتراق، وفيه تذكيرهم بالنعمة
التي هم فيها بعد تلك البلية.
العشرون: تذكيرهم بالنعمة العظمى وهي: إنقاذهم من النار بعد أن كانوا على
شفا حفرة منها.
الحادية والعشرون: ذكره هذا البيان الواضح في آياته.
الثانية والعشرون: أن الفائدة في تعليم العلم تذكر المتعلم واهتداؤه.
الثالثة والعشرون: ذكر الأمر بطائفة متجردة للدعوة إلى الخير، والأمر
بالمعروف والنهي عن المنكر.
الرابعة والعشرون: تخصيصها بالفلاح.
الخامسة والعشرون: نهيهم عن مشابهة الذين تفرقوا واختلفوا من بعد مجيء
الآيات.
السادسة والعشرون: فيه دليل على أن الله ذكر لنا من البينات، في دواء هذا
الداء، ما فيه الشفاء.
السابعة والعشرون: وعيد من ارتكب هذا المنهي عنه بالعذاب الأليم.
الثامنة والعشرون: بياض الوجوه وسوادها. 1 البخاري: العلم [121] ، ومسلم:
الإيمان [65] ، والنسائي: تحريم الدم [4131] ، وابن ماجه: الفتن [3942] ،
وأحمد [4/358، 4/363، 4/366] ، والدارمي: المناسك [1921] .


‏PageV013P00131

التاسعة والعشرون: أن الذين اسودت وجوههم، الذين كفروا بعد إيمانهم، ففيه
أن الواقعة كفر بعد الإيمان أو تجر إليه.
الثلاثون: الوعد الجزيل لمن سلم من ذلك.
الحادية والثلاثون: التذكر أن هذه النصائح والمواعظ هي آيات الله.
الثانية والثلاثون: أنه سبحانه يتلوها على رسوله لأجلنا.
الثالثة والثلاثون: تذكرنا بأن تلك التلاوة بالحق.
الرابعة والثلاثون: الاعتذار بأنه لا يريد ظلم أحد من العالمين.
الخامسة والثلاثون: تذكيرنا بأن له ما في السماوات وما في الأرض.
السادسة والثلاثون: تذكيرنا بالرجوع إليه.



